####################
#                  #
#   ###    ###  #  #
#               #  #
#   ###    ###  #  #
#               #  #
#   ###    ###  #  #
#                  #
####################