############
#G   P..   #
#  ###   # #
#  # #   # #
#  ....    #
#  ### ... #
#      ... #
#  # #   # #
#  ###   # #
#    ..  # #
#  ###   # #
# ...    # #
#   # #    #
#   ##   # #
############


