############
#G   P     #
#  ###   # #
#  # #   # #
############
