############
#G   P..   #
#        # #
#  O     # #
############


