############
#G   P..   #
#        # #
#  .     # #
############


