############
#G   P..   #
#        # #
#        # #
############


